m##############
    ###########
### ###########
##  ###########
##   ####### ##
####    ###  ##
#### ####### ##
###  #####   ##
####         ##
####  ######  #
####  ######  #
##     #####  #
######   ###  #
#####   ###  ##
#######G#######
